############
#####      #
####  P X  #
####       #
######O#####
############