############################################################
##################         #################################
##################X        #################################
##################        X#################################
############      X       X  ###############################
############ ##### ######### ###############################
############ ##### ######### ###############################
############ ##### ######### ###############################
#####        ##### ######### ##################          OO#
#####    X        X                   P                  OO#
################## ############# ##### ########          OO#
##################               ###########################
############################################################